
{
        "1" : "0000000100011100010000000",
        "2" : "0000000100011000001100010",
        "3" : "0010000011000000000000000",
        "4" : "0000000011001000001100000",
        "5" : "0011001000100001000000000",
        "6" : "1101101010000001000111011",
        "7" : "0000001010110110101000000",
        "8" : "1100001000001000100011000",
        "9" : "0101011011000001101101010",
        "10": "0000001000010001011001000",
        "11": "1000001000001000001000001",
        "12": "0000011011000000000000000",
        "13": "1101110101011101010111011",
        "14": "1101111011000001101111011",
        "15": "1111111111101011111111111",
        "16": "0000010101101011010100000",
        "17": "1101111011110111101111011",
        "18": "1111111111110111111111111",
        "19": "1010110101101011010110101",
        "20": "0111001110011100111001110",
        "21": "0101011111011101111101010",
        "22": "0010001010101010101000100",
        "23": "1000101010000000101010001",
        "24": "0111010001101011000101110",
        "25": "1000100000000000000010001",
        "26": "1111111111111111111111111",
        "27": "0000000000111001111111111"

}